..............................
..............................
..............................
..............................
..............................
..............................
..............................
..............................
..............................
..............................
..........................-...
..................---...---...
..............-------.........
.............--------.........
------------------------------