..............................
..............................
..............................
..............................
..............................
..............................
..............................
..............................
..............................
..............................
..........................-...
..................---.R.---...
..............-------.........
.............--------.........
------------------------------