............................................................
............................................................
............................................................
............................................................
............................................................
.........C..................................................
......!...!.................................................
........---.................................................
............................................................
............................................................
..........C...!..........-..................................
..................---.R.---.................................
..............-------.......................................
..#....@....!--------.........------------------------------
------------------------------------------------------------