............................................................
............................................................
............................................................
............................................................
............................................................
............................................................
......!..C!.................................................
........---.................................................
............................................................
............................................................
..............!..C.......-..................................
..................---.R.---.................................
..............-------.......................................
..#....@....!--------.........------------------------------
------------------------------------------------------------