...........................................................................................................................
...........................................................................................................................
...........................................................................................................................
...........................................................................................................................
...........................................................................................................................
........---................................................................................................................
...........................................................................................................................
...........................................................................................................................
...........................................................................................................................
...........................................................................................................................
..........................-................................................................................................
.........-........---.R.---...--------..................-..................-.....................-.................-.......
..............-------...............-.-.-....-.-..-....-..-..-.-..-..-..-....-....-.....-....-..-...-.......-..............
.............--------......................................-......-.-.-.-.-.-.................-.-.-.-.-..-.-.-.-.-.-.-.-.-.
---------------------------------------------------------------------------------------------------------------------------