-..------------------------------------------------------------------------------------------------------------------------
-.........................................................................................................................-
-.........................................................................................................................-
-.........................................................................................................................-
-..C......................................................................................................................-
-.........................................................................................................................-
-.........................................................................................................................-
-.........................................................................................................................-
-.........................................................................................................................-
-.........................................................................................................................-
-.........................................................................................................................-
-.........................................................................................................................-
-.........................................................................................................................-
-.........................................................................................................................-
-.........................................................................................................................-
-.............C...........................................................................................................-
-.........................................................................................................................-
-.........................................................................................................................-
-.......................................^^^...............................................................................-
-........P...........*..*..*..**..**............***......*.....$..........................................................-
-.......&&&......*....................................**..................................................................-
-......&&&&&....*.........................................................................................................-
---------------------------------------------------------------------------------------------------------------------------