..............................
..............................
..............................
..............................
..............................
..............................
..............................
..............................
..............................
..............................
..........................-...
.........-........---.R.---...
..............-------.........
.............--------.........
------------------------------