............................................................
............................................................
............................................................
............................................................
............................................................
............................................................
............................................................
........---.................................................
............................................................
............................................................
.........................-..................................
..................---...---.................................
..............-------.......................................
......4.!.#.@--------.........------------------------------
------------------------------------------------------------