..............................
..............................
..............................
..............................
..............................
..............................
..............................
..............................
..............................
..............................
..........................-...
.........-........---.R.---...
..............-------.........
......C......--------.........
------------------------------