............................................................
............................................................
............................................................
............................................................
............................................................
............................................................
............................................................
........---.................................................
............................................................
............................................................
.........................-..................................
..................---...---.................................
..............-------.......................................
........!.#.@--------.........------------------------------
------------------------------------------------------------