..............................
..............................
..............................
..............................
..............................
..............................
..............................
..............................
..............................
..............................
..........................-...
..................---.R.---...
..............-------.........
......C......--------.........
------------------------------